!
RGBRGBRGBRGBRGBR
GBRGBRGBRGBRGBRG
GBRGBRGBRGBRGBRG
BRGBRGBRGBRGBRGB
BRGBRGBRGBRGBRGB
RGBRGBRGBRGBRGBR
RGBRGBRGBRGBRGBR
GBRGBRGBRGBRGBRG
GBRGBRGBRGBRGBRG
BRGBRGBRGBRGBRGB
!