!
RGRRGRRGRRGRRGRR
GRRGRRGRRGRRGRRG
GRRGRRGRRGRRGRRG
RRGRRGRRGRRGRRGR
RRGRRGRRGRRGRRGR
RGRRGRRGRRGRRGRR
RGBBBRRGRRGBBBRR
GRRGRRGRRGRRGRRG
GRRGRRGRRGRRGRRG
BBBBBBBBBBBBBBBB
!